almost clear=شبه صاف
broken=مكسور
clear=صاف
clear or partly cloudy=صاف أو جزئيًا غائم
clear with haze=صاف مع ضباب
clear with light haze=صاف مع ضباب خفيف
cloudy or very cloudy=غائم أو غائم جدًا
cloudy with extensive haze=غائم مع ضباب كثيف
cloudy with local openings=غائم مع فتحات محلية
fog=ضباب
foggy weather=طقس ضبابي
foggy weather and very low visibility=طقس ضبابي ورؤية منخفضة جدًا
freezing fog=ضباب متجمد
gray sky due to low clouds=سماء رمادية بسبب السحب المنخفضة
half cloudy=غائم جزئيًا
heavy rain=أمطار غزيرة
heavy snow and fog=ثلوج غزيرة وضباب
irregular clouds with heavy rain=سحب غير منتظمة مع أمطار غزيرة
irregular clouds with possible thunderstorm=سحب غير منتظمة مع عاصفة رعدية محتملة
irregular clouds with possible thunderstorms and fog=سحب غير منتظمة مع عواصف رعدية محتملة وضباب
irregular clouds with rain showers=سحب غير منتظمة مع أمطار متفرقة
irregular clouds with snow=سحب غير منتظمة مع ثلوج
irregular clouds with snow showers=سحب غير منتظمة مع أمطار ثلجية
irregular clouds with strong thunderstorm=سحب غير منتظمة مع عاصفة رعدية قوية
irregular clouds with thunderstorms=سحب غير منتظمة مع عواصف رعدية
irregular clouds with very heavy rain=سحب غير منتظمة مع أمطار غزيرة جدًا
low clouds with some clearings=سحب منخفضة مع بعض الفتحات
mostly clear=صاف في الغالب
no precipitation=لا توجد هطولات
overcast=غائم
overcast with drizzle=غائم مع رذاذ
overcast with drizzle and fog=غائم مع رذاذ وضباب
overcast with freezing rain=غائم مع أمطار متجمدة
overcast with heavy snow=غائم مع ثلوج غزيرة
overcast with heavy snow of a blizzard nature=غائم مع ثلوج غزيرة من نوع عاصفة ثلجية
overcast with heavy snow of a blizzard nature and fog=غائم مع ثلوج غزيرة من نوع عاصفة ثلجية وضباب
overcast with light rain=غائم مع أمطار خفيفة
overcast with light rain and fog=غائم مع أمطار خفيفة وضباب
overcast with light snow=غائم مع ثلوج خفيفة
overcast with light snow and fog=غائم مع ثلوج خفيفة وضباب
overcast with possible rain=غائم مع أمطار محتملة
overcast with possible rain and fog=غائم مع أمطار محتملة وضباب
overcast with rain=غائم مع أمطار
overcast with rain and fog=غائم مع أمطار وضباب
overcast with rain mixed with snow=غائم مع أمطار مختلطة بالثلوج
overcast with rain showers=غائم مع أمطار متفرقة
overcast with rain showers and fog=غائم مع أمطار متفرقة وضباب
overcast with round snow showers=غائم مع أمطار ثلجية مستديرة
overcast with sleet=غائم مع أمطار متجمدة
overcast with sleet and fog=غائم مع أمطار متجمدة وضباب
overcast with snow=غائم مع ثلوج
overcast with snow and fog=غائم مع ثلوج وضباب
overcast with snow showers=غائم مع أمطار ثلجية
overcast with snow showers and fog=غائم مع أمطار ثلجية وضباب
overcast with snow storms=غائم مع عواصف ثلجية
partly cloudy=غائم جزئيًا
partly or partly cloudy with scattered haze=غائم جزئيًا أو جزئيًا مع ضباب متفرق
precipitation=هطول الأمطار
rain=أمطار
reduced visibility due to fog banks=رؤية محدودة بسبب الضباب
scattered clouds and clearings=سحب متفرقة مع فتحات
scattered clouds with drizzle=سحب متفرقة مع رذاذ
scattered clouds with large clearings=سحب متفرقة مع فتحات واسعة
scattered clouds with light rain=سحب متفرقة مع أمطار خفيفة
scattered clouds with light snow=سحب متفرقة مع ثلوج خفيفة
scattered clouds with possible rain=سحب متفرقة مع أمطار محتملة
scattered clouds with possible thunderstorms=سحب متفرقة مع عواصف رعدية محتملة
scattered clouds with rain=سحب متفرقة مع أمطار
scattered clouds with sleet=سحب متفرقة مع أمطار متجمدة
severe thunderstorms=عواصف رعدية شديدة
severe thunderstorms and fog=عواصف رعدية شديدة وضباب
severe thunderstorms with hail=عواصف رعدية شديدة مع بَرَد
showers=أمطار متفرقة
sleet=أمطار متجمدة
slight precipitation=هطول أمطار خفيف
snow=ثلوج
thin high clouds=سحب رقيقة وعالية
thunder=رعد
very cloudy or overcast=غائم جدًا أو غائم كليًا
very cloudy or overcast with high clouds=غائم جدًا أو غائم كليًا مع سحب عالية
very cloudy with rain and thunderstorms=غائم جدًا مع أمطار وعواصف رعدية
very cloudy with rain and thunderstorms and fog=غائم جدًا مع أمطار وعواصف رعدية وضباب
very heavy rain, locally flooding=أمطار غزيرة جدًا، مع فيضانات محلية