april=duben
august=srpen
december=prosinec
february=únor
friday=pátek
january=leden
july=červenec
june=červen
march=březen
may=květen
monday=pondělí
november=listopad
october=říjen
saturday=sobota
september=září
sunday=neděle
thursday=čtvrtek
tuesday=úterý
wednesday=středa
almost clear=téměř jasno
almost=téměř
and=a
broken=zlomený
clear or partly cloudy=jasno nebo částečně zataženo
clear with haze=jasno s mlhou
clear with light haze=jasno s lehkou mlhou
clear=jasno
clearings=jasná místa
cloudy or very cloudy=zataženo nebo velmi zataženo
cloudy with extensive haze=zataženo s rozsáhlou mlhou
cloudy with local openings=zataženo s místními rozjasněními
cloudy=zataženo
drizzle=mrholení
due=díky
extensive=rozsáhlý
flooding=zatopení
fog=mlha
foggy weather and very low visibility=mlhavé počasí a velmi špatná viditelnost
foggy weather=mlhavé počasí
foggy=mlhavý
freezing fog=mrznoucí mlha
freezing=mrznoucí
gray sky due to low clouds=šedá obloha kvůli nízkým mrakům
gray=šedý
hail=kroupy
half cloudy=polojasno
half=polovina
haze=mlha
heavy rain=silný déšť
heavy snow and fog=silné sněžení a mlha
heavy=těžký
high=vysoký
irregular clouds with heavy rain=nepravidelná oblaka se silným deštěm
irregular clouds with possible thunderstorm=nepravidelná oblaka s možnou bouřkou
irregular clouds with possible thunderstorms and fog=nepravidelná oblaka s možnými bouřkami a mlhou
irregular clouds with rain showers=nepravidelná oblaka s přeháňkami
irregular clouds with snow showers=nepravidelná oblaka se sněhovými přeháňkami
irregular clouds with snow=nepravidelná oblaka se sněhem
irregular clouds with strong thunderstorm=nepravidelná oblaka se silnou bouřkou
irregular clouds with thunderstorms=nepravidelná oblaka s bouřkami
irregular clouds with very heavy rain=nepravidelná oblaka s velmi silným deštěm
irregular=nepravidelný
light=světlý
local=místní
low clouds with some clearings=nízká oblaka s některými rozjasněními
low=nízký
mostly clear=většinou jasno
mostly=většinou
no precipitation=žádné srážky
no=ne
openings=otevření
or=nebo
overcast with drizzle and fog=zataženo s mrholením a mlhou
overcast with drizzle=zataženo s mrholením
overcast with freezing rain=zataženo s mrznoucím deštěm
overcast with heavy snow of a blizzard nature and fog=zataženo se silným sněžením typu blizardu a mlhou
overcast with heavy snow of a blizzard nature=zataženo se silným sněžením typu blizardu
overcast with heavy snow=zataženo se silným sněžením
overcast with light rain and fog=zataženo s lehkým deštěm a mlhou
overcast with light rain=zataženo s lehkým deštěm
overcast with light snow and fog=zataženo s lehkým sněžením a mlhou
overcast with light snow=zataženo s lehkým sněžením
overcast with possible rain and fog=zataženo s možným deštěm a mlhou
overcast with possible rain=zataženo s možným deštěm
overcast with rain and fog=zataženo s deštěm a mlhou
overcast with rain mixed with snow=zataženo s deštěm smíchaným se sněhem
overcast with rain showers and fog=zataženo s přeháňkami a mlhou
overcast with rain showers=zataženo s přeháňkami
overcast with rain=zataženo s deštěm
overcast with round snow showers=zataženo s kruhovými sněhovými přeháňkami
overcast with sleet and fog=zataženo s deštěm se sněhem a mlhou
overcast with sleet=zataženo s deštěm se sněhem
overcast with snow and fog=zataženo se sněhem a mlhou
overcast with snow showers and fog=zataženo se sněhovými přeháňkami a mlhou
overcast with snow showers=zataženo se sněhovými přeháňkami
overcast with snow storms=zataženo se sněhovými bouřemi
overcast with snow=zataženo se sněhem
overcast=zataženo
partly cloudy=částečně zataženo
partly or partly cloudy with scattered haze=částečně nebo částečně zataženo s rozptýlenou mlhou
partly=částečně
possible=možné
precipitation=srážky
rain=déšť
reduced visibility due to fog banks=snížená viditelnost kvůli mlžným bankám
round=kulatý
scattered clouds and clearings=rozptýlená oblaka a rozjasnění
scattered clouds with drizzle=rozptýlená oblaka s mrholením
scattered clouds with large clearings=rozptýlená oblaka s velkými rozjasněními
scattered clouds with light rain=rozptýlená oblaka s lehkým deštěm
scattered clouds with light snow=rozptýlená oblaka s lehkým sněžením
scattered clouds with possible rain=rozptýlená oblaka s možným deštěm
scattered clouds with possible thunderstorms=rozptýlená oblaka s možnými bouřkami
scattered clouds with rain=rozptýlená oblaka s deštěm
scattered clouds with sleet=rozptýlená oblaka s deštěm se sněhem
severe thunderstorms and fog=silné bouřky a mlha
severe thunderstorms with hail=silné bouřky s kroupami
severe thunderstorms=silné bouřky
showers=přeháňky
sky=obloha
sleet=mrznoucí déšť
slight precipitation=lehké srážky
slight=lehké
snow=sníh
some=některé
storms=bouře
strong=silný
thin high clouds=tenká vysoká oblaka
thin=tenký
thunder=hrom
thunderstorm=bouřka
to=do
very cloudy or overcast with high clouds=velmi zataženo nebo zataženo s vysokými oblaky
very cloudy or overcast=velmi zataženo
very cloudy with rain and thunderstorms and fog=velmi zataženo s deštěm, bouřkami a mlhou
very heavy rain, locally flooding=velmi silný déšť, místní záplavy
very=velmi
visibility=viditelnost
weather=počasí
with=s