April=April
August=August
December=Dezember
February=Februar
Friday=Freitag
January=Januar
July=Juli
June=Juni
March=März
May=Mai
Monday=Montag
November=November
October=Oktober
Saturday=Samstag
September=September
Sunday=Sonntag
Thursday=Donnerstag
Tuesday=Dienstag
Wednesday=Mittwoch
almost clear=meist klar
almost=meist
and=und
broken=zerbrochen
clear or partly cloudy=klar oder teils bewölkt
clear with haze=klar mit Dunst
clear with light haze=klar mit leichtem Dunst
clear=klar
clearings=Auflockerungen
cloudy or very cloudy=bewölkt oder sehr bewölkt
cloudy with extensive haze=bewölkt mit starkem Dunst
cloudy with local openings=bewölkt mit lokalen Auflockerungen
cloudy=bewölkt
drizzle=Nieselregen
due=aufgrund
extensive=ausgedehnt
flooding=Hochwasser
fog=Nebel
foggy weather and very low visibility=Nebel mit sehr geringer Sicht
foggy weather=Nebel
foggy=neblig
freezing fog=Frostnebel
freezing=gefroren
gray sky due to low clouds=grauer Himmel aufgrund niedriger Wolken
gray=grau
hail=Hagel
half cloudy=halb bewölkt
half=halb
haze=Dunst
heavy rain=starker Regen
heavy snow and fog=starker Schneefall und Nebel
heavy=stark
high=hoch
irregular clouds with heavy rain=gebietsweise bewölkt mit starkem Regen
irregular clouds with possible thunderstorm=gebietsweise bewölkt mit möglichem Gewitter
irregular clouds with possible thunderstorms and fog=gebietsweise bewölkt mit möglichen Gewittern und Nebel
irregular clouds with rain showers=gebietsweise bewölkt mit Regenschauern
irregular clouds with snow showers=gebietsweise bewölkt mit Schneeschauern
irregular clouds with snow=gebietsweise bewölkt mit Schneefall
irregular clouds with strong thunderstorm=gebietsweise bewölkt mit starkem Gewitter
irregular clouds with thunderstorms=gebietsweise bewölkt mit Gewittern
irregular clouds with very heavy rain=gebietsweise bewölkt mit sehr starkem Regen
irregular=gebietsweise
light=leichter
local=lokal
low clouds with some clearings=niedrige Wolken mit einigen Auflockerungen
low=gering
mostly clear=meist klar
mostly=meist
no precipitation=keine Niederschläge
no=kein
openings=Öffnungen
or=oder
overcast with drizzle and fog=bedeckt mit Nieselregen und Nebel
overcast with drizzle=bedeckt mit Nieselregen
overcast with freezing rain=bedeckt mit gefrierendem Regen
overcast with heavy snow of a blizzard nature and fog=bedeckt mit starkem Schneefall und Nebel, starker Schneesturm!
overcast with heavy snow of a blizzard nature=bedeckt mit starkem Schneefall, starker Schneesturm!
overcast with heavy snow=bedeckt mit starkem Schneefall
overcast with light rain and fog=bedeckt mit leichtem Regen und Nebel
overcast with light rain=bedeckt mit leichtem Regen
overcast with light snow and fog=bedeckt mit leichtem Schneefall und Nebel
overcast with light snow=bedeckt mit leichtem Schneefall
overcast with possible rain and fog=bedeckt mit möglichem Regen und Nebel
overcast with possible rain=bedeckt mit möglichem Regen
overcast with rain and fog=bedeckt mit Regen und Nebel
overcast with rain mixed with snow=bedeckt mit Regen, vermischt mit Schnee
overcast with rain showers and fog=bedeckt mit Regenschauern und Nebel
overcast with rain showers=bedeckt mit Regenschauern
overcast with rain=bedeckt mit Regen
overcast with round snow showers=bedeckt mit reihenweise Schneeschauer
overcast with sleet and fog=bedeckt mit Graupel und Nebel
overcast with sleet=bedeckt mit Graupel
overcast with snow and fog=bedeckt mit Schnee und Nebel
overcast with snow showers and fog=bedeckt mit Schneeschauern und Nebel
overcast with snow showers=bedeckt mit Schneeschauern
overcast with snow storms=bedeckt mit Schneestürmen
overcast with snow=bedeckt mit Schneefall
overcast=bedeckt
showers=Regenschauer
sky=Himmel
sleet=Graupel
slight precipitation=geringer Niederschlag
slight=gering
snow=Schneefall
some=einige
storms=Stürme
strong=stark
thin high clouds=dünne hohe Wolken
thin=dünn
thunder=Donner
thunderstorm=Gewitter
to=zu
partly cloudy=teils bewölkt
partly=teils
possible=möglich
precipitation=Niederschlag
rain=Regen
very=stark
visibility=Sicht
weather=Wetter
with=mit
round=reihenweise
partly or partly cloudy with scattered haze=teils oder teils bewölkt mit verstreutem Dunst
reduced visibility due to fog banks=eingeschränkte Sicht aufgrund von Nebelbänken
overcast and wet snow showers=bedeckt und Schneeregenschauer
overcast and light wet snow=bedeckt und leichter Schneeregen
overcast and wet snow=bedeckt und Schneeregen
scattered clouds and clearings=vereinzelt Wolken mit Auflockerungen
scattered clouds with drizzle=vereinzelt Wolken mit Nieselregen
scattered clouds with large clearings=vereinzelt Wolken mit großen Auflockerungen
scattered clouds with light rain=vereinzelt Wolken mit leichtem Regen
scattered clouds with light snow=vereinzelt Wolken mit leichtem Schneefall
scattered clouds with possible thunderstorms=vereinzelt Wolken mit möglichem Gewitter
scattered clouds with rain=vereinzelt Wolken mit Regen
scattered clouds with sleet=vereinzelt Wolken mit Graupel
severe thunderstorms and fog=schwere Gewitter und Nebel
severe thunderstorms with hail=schwere Gewitter mit Hagel
severe thunderstorms=schwere Gewitter
very cloudy or overcast with high clouds=stark bewölkt oder bedeckt mit hohen Wolken
very cloudy or overcast=stark bewölkt oder bedeckt
very cloudy with rain and thunderstorms and fog=stark bewölkt mit Regen, Gewittern und Nebel
very cloudy with rain and thunderstorms=stark bewölkt mit Regen und Gewittern
very heavy rain, locally flooding=sehr starker Regen, örtlich Hochwasser