april=απρίλιος
august=αύγουστος
december=δεκέμβριος
february=φεβρουάριος
friday=παρασκευή
january=ιανουάριος
july=ιούλιος
june=ιούνιος
march=μάρτιος
may=μάιος
monday=δευτέρα
november=νοέμβριος
october=οκτώβριος
saturday=σάββατο
september=σεπτέμβριος
sunday=κυριακή
thursday=πέμπτη
tuesday=τρίτη
wednesday=τετάρτη
almost clear=σχεδόν καθαρός
almost=σχεδόν
and=και
broken=σπασμένος
clear or partly cloudy=καθαρός ή μερικώς νεφελώδης
clear with haze=καθαρός με ομίχλη
clear with light haze=καθαρός με ελαφριά ομίχλη
clear=καθαρός
clearings=καθαρίσματα
cloudy or very cloudy=συννεφιασμένος ή πολύ συννεφιασμένος
cloudy with extensive haze=συννεφιασμένος με εκτεταμένη ομίχλη
cloudy with local openings=συννεφιασμένος με τοπικά ανοίγματα
cloudy=συννεφιασμένος
drizzle=ψιχάλες
due=λόγω
extensive=εκτεταμένος
flooding=πλημμύρα
fog=ομίχλη
foggy weather and very low visibility=ομιχλώδης καιρός και πολύ χαμηλή ορατότητα
foggy weather=ομιχλώδης καιρός
foggy=ομιχλώδης
freezing fog=παγωμένη ομίχλη
freezing=παγωμένος
gray sky due to low clouds=γκρίζος ουρανός λόγω χαμηλών σύννεφων
gray=γκρίζος
hail=χαλάζι
half cloudy=μισοσυννεφιασμένος
half=μισός
haze=ομίχλη
heavy rain=ισχυρή βροχή
heavy snow and fog=ισχυρή χιονόπτωση και ομίχλη
heavy=βαρύς
high=ψηλός
irregular clouds with heavy rain=ακανόνιστα σύννεφα με ισχυρή βροχή
irregular clouds with possible thunderstorm=ακανόνιστα σύννεφα με πιθανή καταιγίδα
irregular clouds with possible thunderstorms and fog=ακανόνιστα σύννεφα με πιθανές καταιγίδες και ομίχλη
irregular clouds with rain showers=ακανόνιστα σύννεφα με βροχές
irregular clouds with snow showers=ακανόνιστα σύννεφα με χιονοπτώσεις
irregular clouds with snow=ακανόνιστα σύννεφα με χιόνι
irregular clouds with strong thunderstorm=ακανόνιστα σύννεφα με ισχυρή καταιγίδα
irregular clouds with thunderstorms=ακανόνιστα σύννεφα με καταιγίδες
irregular clouds with very heavy rain=ακανόνιστα σύννεφα με πολύ ισχυρή βροχή
irregular=ακανόνιστος
light=ελαφρύς
local=τοπικός
low clouds with some clearings=χαμηλά σύννεφα με κάποιες καθαρίσεις
low=χαμηλός
mostly clear=κυρίως καθαρός
mostly=κυρίως
no precipitation=χωρίς κατακρημνίσεις
no=όχι
openings=ανοίγματα
or=ή
overcast with drizzle and fog=συννεφιασμένος με ψιχάλες και ομίχλη
overcast with drizzle=συννεφιασμένος με ψιχάλες
overcast with freezing rain=συννεφιασμένος με παγωμένη βροχή
overcast with heavy snow of a blizzard nature and fog=συννεφιασμένος με ισχυρή χιονόπτωση τύπου χιονοθύελλας και ομίχλη
overcast with heavy snow of a blizzard nature=συννεφιασμένος με ισχυρή χιονόπτωση τύπου χιονοθύελλας
overcast with heavy snow=συννεφιασμένος με ισχυρή χιονόπτωση
overcast with light rain and fog=συννεφιασμένος με ελαφριά βροχή και ομίχλη
overcast with light rain=συννεφιασμένος με ελαφριά βροχή
overcast with light snow and fog=συννεφιασμένος με ελαφριά χιονόπτωση και ομίχλη
overcast with light snow=συννεφιασμένος με ελαφριά χιονόπτωση
overcast with possible rain and fog=συννεφιασμένος με πιθανή βροχή και ομίχλη
overcast with possible rain=συννεφιασμένος με πιθανή βροχή
overcast with rain and fog=συννεφιασμένος με βροχή και ομίχλη
overcast with rain mixed with snow=συννεφιασμένος με βροχή αναμεμειγμένη με χιόνι
overcast with rain showers and fog=συννεφιασμένος με βροχές και ομίχλη
overcast with rain showers=συννεφιασμένος με βροχές
overcast with rain=συννεφιασμένος με βροχή
overcast with round snow showers=συννεφιασμένος με στρογγυλές χιονόπτωσεις
overcast with sleet and fog=συννεφιασμένος με χιονόνερο και ομίχλη
overcast with sleet=συννεφιασμένος με χιονόνερο
overcast with snow and fog=συννεφιασμένος με χιόνι και ομίχλη
overcast with snow showers and fog=συννεφιασμένος με χιονόπτωσεις και ομίχλη
overcast with snow showers=συννεφιασμένος με χιονόπτωσεις
overcast with snow storms=συννεφιασμένος με χιονοθύελλες
overcast with snow=συννεφιασμένος με χιόνι
overcast=συννεφιασμένος
partly cloudy=μερικώς συννεφιασμένος
partly or partly cloudy with scattered haze=μερικώς ή μερικώς συννεφιασμένος με διάσπαρτη ομίχλη
partly=μερικώς
possible=πιθανό
precipitation=κατακρημνίσεις
rain=βροχή
reduced visibility due to fog banks=μειωμένη ορατότητα λόγω ομίχλης
round=στρογγυλός
scattered clouds and clearings=διάσπαρτα σύννεφα και καθαρίσματα
scattered clouds with drizzle=διάσπαρτα σύννεφα με ψιχάλες
scattered clouds with large clearings=διάσπαρτα σύννεφα με μεγάλα ανοίγματα
scattered clouds with light rain=διάσπαρτα σύννεφα με ελαφριά βροχή
scattered clouds with light snow=διάσπαρτα σύννεφα με ελαφριά χιονόπτωση
scattered clouds with possible rain=διάσπαρτα σύννεφα με πιθανή βροχή
scattered clouds with possible thunderstorms=διάσπαρτα σύννεφα με πιθανές καταιγίδες
scattered clouds with rain=διάσπαρτα σύννεφα με βροχή
scattered clouds with sleet=διάσπαρτα σύννεφα με χιονόνερο
severe thunderstorms and fog=ισχυρές καταιγίδες και ομίχλη
severe thunderstorms with hail=ισχυρές καταιγίδες με χαλάζι
severe thunderstorms=ισχυρές καταιγίδες
showers=βροχές
sky=ουρανός
sleet=χιονόνερο
slight precipitation=ελαφριά κατακρήμνιση
slight=ελαφρύς
snow=χιόνι
some=κάποια
storms=θύελλες
strong=ισχυρός
thin high clouds=λεπτά ψηλά σύννεφα
thin=λεπτός
thunder=βροντή
thunderstorm=καταιγίδα
to=σε
very cloudy or overcast with high clouds=πολύ συννεφιασμένος ή με υψηλά σύννεφα
very cloudy or overcast=πολύ συννεφιασμένος
very cloudy with rain and thunderstorms and fog=πολύ συννεφιασμένος με βροχή, καταιγίδες και ομίχλη
very heavy rain, locally flooding=πολύ ισχυρή βροχή, τοπικά πλημμύρες
very=πολύ
visibility=ορατότητα
weather=καιρός
with=με