almost clear=casi claro
broken=roto
clear=claro
clear or partly cloudy=claro o parcialmente nublado
clear with haze=claro con niebla
clear with light haze=claro con ligera niebla
cloudy or very cloudy=nublado o muy nublado
cloudy with extensive haze=nublado con niebla extensa
cloudy with local openings=nublado con aperturas locales
fog=niebla
foggy weather=clima con niebla
foggy weather and very low visibility=clima con niebla y visibilidad muy baja
freezing fog=niebla helada
gray sky due to low clouds=cielo gris debido a nubes bajas
half cloudy=medio nublado
heavy rain=lluvia intensa
heavy snow and fog=nieve intensa y niebla
irregular clouds with heavy rain=nubes irregulares con lluvia intensa
irregular clouds with possible thunderstorm=nubes irregulares con posible tormenta
irregular clouds with possible thunderstorms and fog=nubes irregulares con posibles tormentas y niebla
irregular clouds with rain showers=nubes irregulares con chubascos
irregular clouds with snow=nubes irregulares con nieve
irregular clouds with snow showers=nubes irregulares con chubascos de nieve
irregular clouds with strong thunderstorm=nubes irregulares con tormenta fuerte
irregular clouds with thunderstorms=nubes irregulares con tormentas
irregular clouds with very heavy rain=nubes irregulares con lluvia muy intensa
low clouds with some clearings=nubes bajas con algunas aclaraciones
mostly clear=mayormente claro
no precipitation=sin precipitaciones
overcast=nublado
overcast with drizzle=nublado con llovizna
overcast with drizzle and fog=nublado con llovizna y niebla
overcast with freezing rain=nublado con lluvia helada
overcast with heavy snow=nublado con nieve intensa
overcast with heavy snow of a blizzard nature=nublado con nieve intensa de naturaleza tormentosa
overcast with heavy snow of a blizzard nature and fog=nublado con nieve intensa de naturaleza tormentosa y niebla
overcast with light rain=nublado con lluvia ligera
overcast with light rain and fog=nublado con lluvia ligera y niebla
overcast with light snow=nublado con nieve ligera
overcast with light snow and fog=nublado con nieve ligera y niebla
overcast with possible rain=nublado con posible lluvia
overcast with possible rain and fog=nublado con posible lluvia y niebla
overcast with rain=nublado con lluvia
overcast with rain and fog=nublado con lluvia y niebla
overcast with rain mixed with snow=nublado con lluvia mezclada con nieve
overcast with rain showers=nublado con chubascos de lluvia
overcast with rain showers and fog=nublado con chubascos de lluvia y niebla
overcast with round snow showers=nublado con chubascos redondos de nieve
overcast with sleet=nublado con aguanieve
overcast with sleet and fog=nublado con aguanieve y niebla
overcast with snow=nublado con nieve
overcast with snow and fog=nublado con nieve y niebla
overcast with snow showers=nublado con chubascos de nieve
overcast with snow showers and fog=nublado con chubascos de nieve y niebla
overcast with snow storms=nublado con tormentas de nieve
partly cloudy=parcialmente nublado
partly or partly cloudy with scattered haze=parcialmente o parcialmente nublado con niebla dispersa
precipitation=precipitaciones
rain=lluvia
reduced visibility due to fog banks=visibilidad reducida debido a bancos de niebla
scattered clouds and clearings=nubes dispersas y aclaraciones
scattered clouds with drizzle=nubes dispersas con llovizna
scattered clouds with large clearings=nubes dispersas con grandes aclaraciones
scattered clouds with light rain=nubes dispersas con lluvia ligera
scattered clouds with light snow=nubes dispersas con nieve ligera
scattered clouds with possible rain=nubes dispersas con posible lluvia
scattered clouds with possible thunderstorms=nubes dispersas con posibles tormentas
scattered clouds with rain=nubes dispersas con lluvia
scattered clouds with sleet=nubes dispersas con aguanieve
severe thunderstorms=tormentas severas
severe thunderstorms and fog=tormentas severas y niebla
severe thunderstorms with hail=tormentas severas con granizo
showers=chubascos
sleet=aguanieve
slight precipitation=ligera precipitaci√≥n
snow=nieve
thin high clouds=nubes altas delgadas
thunder=trueno
very cloudy or overcast=muy nublado o cubierto
very cloudy or overcast with high clouds=muy nublado o cubierto con nubes altas
very cloudy with rain and thunderstorms=muy nublado con lluvia y tormentas
very cloudy with rain and thunderstorms and fog=muy nublado con lluvia, tormentas y niebla
very heavy rain, locally flooding=lluvia muy fuerte, con inundaciones locales