april=aprill
august=august
december=detsember
february=veebruar
friday=reede
january=jaanuar
july=juuli
june=juuni
march=märts
may=mai
monday=esmaspäev
november=november
october=oktoober
saturday=laupäev
september=september
sunday=pühapäev
thursday=neljapäev
tuesday=teisipäev
wednesday=kolmapäev
almost clear=peaaegu selge
almost=peaaegu
and=ja
broken=katkine
clear or partly cloudy=selge või osaliselt pilves
clear with haze=selge vinega
clear with light haze=selge kerge vinega
clear=selge
clearings=selginemised
cloudy or very cloudy=pilves või väga pilves
cloudy with extensive haze=pilves tiheda vinega
cloudy with local openings=pilves kohalike selginemistega
cloudy=pilves
drizzle=uduvihm
due=seetõttu
extensive=ulatuslik
flooding=üleujutus
fog=udu
foggy weather and very low visibility=udune ilm ja väga halb nähtavus
foggy weather=udune ilm
foggy=udune
freezing fog=külmuv udu
freezing=külmumine
gray sky due to low clouds=hall taevas madalate pilvede tõttu
gray=hall
hail=rahe
half cloudy=osaliselt pilves
half=pool
haze=vine
heavy rain=tugev vihm
heavy snow and fog=tugev lumi ja udu
heavy=raske
high=kõrge
irregular clouds with heavy rain=ebakorrapärased pilved tugeva vihmaga
irregular clouds with possible thunderstorm=ebakorrapärased pilved võimaliku äikesega
irregular clouds with possible thunderstorms and fog=ebakorrapärased pilved võimaliku äikese ja uduga
irregular clouds with rain showers=ebakorrapärased pilved vihmahoogudega
irregular clouds with snow showers=ebakorrapärased pilved lumehoogudega
irregular clouds with snow=ebakorrapärased pilved lumega
irregular clouds with strong thunderstorm=ebakorrapärased pilved tugeva äikesega
irregular clouds with thunderstorms=ebakorrapärased pilved äikestega
irregular clouds with very heavy rain=ebakorrapärased pilved väga tugeva vihmaga
irregular=ebakorrapärane
light=kerge
local=kohalik
low clouds with some clearings=madalad pilved mõningate selginemistega
low=madal
mostly clear=enamasti selge
mostly=enamasti
no precipitation=sademeteta
no=ei
openings=avad
or=või
overcast with drizzle and fog=pilves uduvihma ja uduga
overcast with drizzle=pilves uduvihmaga
overcast with freezing rain=pilves jäätuva vihmaga
overcast with heavy snow of a blizzard nature and fog=pilves tugeva tuisuse lumega ja uduga
overcast with heavy snow of a blizzard nature=pilves tugeva tuisuse lumega
overcast with heavy snow=pilves tugeva lumega
overcast with light rain and fog=pilves kerge vihma ja uduga
overcast with light rain=pilves kerge vihmaga
overcast with light snow and fog=pilves kerge lume ja uduga
overcast with light snow=pilves kerge lumega
overcast with possible rain and fog=pilves võimaliku vihma ja uduga
overcast with possible rain=pilves võimaliku vihmaga
overcast with rain and fog=pilves vihma ja uduga
overcast with rain mixed with snow=pilves vihma ja lumega
overcast with rain showers and fog=pilves vihmahoogude ja uduga
overcast with rain showers=pilves vihmahoogudega
overcast with rain=pilves vihmaga
overcast with round snow showers=pilves ümarate lumehoogudega
overcast with sleet and fog=pilves lörtsi ja uduga
overcast with sleet=pilves lörtsiga
overcast with snow and fog=pilves lume ja uduga
overcast with snow showers and fog=pilves lumehoogude ja uduga
overcast with snow showers=pilves lumehoogudega
overcast with snow storms=pilves lumetormidega
overcast with snow=pilves lumega
overcast=pilves
partly cloudy=osaliselt pilves
partly or partly cloudy with scattered haze=osaliselt või osaliselt pilves hajutatud vinega
partly=osaliselt
possible=võimalik
precipitation=sademed
rain=vihm
reduced visibility due to fog banks=halvenenud nähtavus udupankade tõttu
round=ümar
scattered clouds and clearings=hajutatud pilved ja selginemised
scattered clouds with drizzle=hajutatud pilved uduvihmaga
scattered clouds with large clearings=hajutatud pilved suurte selginemistega
scattered clouds with light rain=hajutatud pilved kerge vihmaga
scattered clouds with light snow=hajutatud pilved kerge lumega
scattered clouds with possible rain=hajutatud pilved võimaliku vihmaga
scattered clouds with possible thunderstorms=hajutatud pilved võimalike äikestega
scattered clouds with rain=hajutatud pilved vihmaga
scattered clouds with sleet=hajutatud pilved lörtsiga
severe thunderstorms and fog=tõsised äikesed ja udu
severe thunderstorms with hail=tõsised äikesed rahega
severe thunderstorms=tõsised äikesed
showers=hoovihmad
sky=taevas
sleet=lörts
slight precipitation=kerged sademed
slight=kergelt
snow=lumi
some=mõned
storms=tormid
strong=tugev
thin high clouds=õhukesed kõrged pilved
thin=õhuke
thunder=äike
thunderstorm=äike
to=kuni
very cloudy or overcast with high clouds=väga pilves või täielikult pilves kõrgete pilvedega
very cloudy or overcast=väga pilves või täielikult pilves
very cloudy with rain and thunderstorms and fog=väga pilves vihma, äikese ja uduga
very heavy rain, locally flooding=väga tugev vihm, kohalikud üleujutused
very=väga
visibility=nähtavus
weather=ilm
with=koos