april=huhtikuu
august=elokuu
december=joulukuu
february=helmikuu
friday=perjantai
january=tammikuu
july=heinäkuu
june=kesäkuu
march=maalis
may=toukokuu
monday=maanantai
november=marraskuu
october=lokakuu
saturday=lauantai
september=syyskuu
sunday=sunnuntai
thursday=torstai
tuesday=tiistai
wednesday=keskiviikko
almost clear= melkein selkeä
almost= melkein
and= ja
broken= rikki
clear or partly cloudy= selkeä tai osittain pilvinen
clear with haze= selkeä sumussa
clear with light haze= selkeä kevyessä sumussa
clear= selkeä
clearings= selkeät alueet
cloudy or very cloudy= pilvinen tai hyvin pilvinen
cloudy with extensive haze= pilvinen laajalla sumulla
cloudy with local openings= pilvinen paikallisilla aukkoilla
cloudy= pilvinen
drizzle= tihkusateet
due= johtuen
extensive= laaja
flooding= tulvia
fog= sumu
foggy weather and very low visibility= sumuista säätä ja erittäin huono näkyvyys
foggy weather= sumuista säätä
foggy= sumuista
freezing fog= jäätyvä sumu
freezing= jäätynyt
gray sky due to low clouds= harmaa taivas matalista pilvistä johtuen
gray= harmaa
hail= rakeet
half cloudy= puolipilvinen
half= puoliksi
haze= usva
heavy rain= rankkasateet
heavy snow and fog= raskas lumisateet ja sumu
heavy= raskas
high= korkea
irregular clouds with heavy rain= epäsäännölliset pilvet rankkasateilla
irregular clouds with possible thunderstorm= epäsäännölliset pilvet mahdollisella ukkosella
irregular clouds with possible thunderstorms and fog= epäsäännölliset pilvet mahdollisilla ukkosilla ja sumulla
irregular clouds with rain showers= epäsäännölliset pilvet sadekuuroilla
irregular clouds with snow showers= epäsäännölliset pilvet lumisateilla
irregular clouds with snow= epäsäännölliset pilvet lumella
irregular clouds with strong thunderstorm= epäsäännölliset pilvet voimakkaalla ukkosella
irregular clouds with thunderstorms= epäsäännölliset pilvet ukkosilla
irregular clouds with very heavy rain= epäsäännölliset pilvet erittäin rankkasateilla
irregular= epäsäännöllinen
light= kevyt
local= paikallinen
low clouds with some clearings= matalat pilvet joillain selkeillä alueilla
low= matala
mostly clear= pääasiassa selkeä
mostly= pääasiassa
mostly= pääasiassa
no precipitation= ei sadetta
no= ei
openings= aukot
or= tai
overcast with drizzle and fog= pilvinen tihkusateella ja sumulla
overcast with drizzle= pilvinen tihkusateella
overcast with freezing rain= pilvinen jäätyvällä sateella
overcast with heavy snow of a blizzard nature and fog= pilvinen voimakkaalla lumisateella myrskyluonteinen ja sumu
overcast with heavy snow of a blizzard nature= pilvinen voimakkaalla lumisateella myrskyluonteinen
overcast with heavy snow= pilvinen voimakkaalla lumisateella
overcast with light rain and fog= pilvinen kevyellä sateella ja sumulla
overcast with light rain= pilvinen kevyellä sateella
overcast with light snow and fog= pilvinen kevyellä lumisateella ja sumulla
overcast with light snow= pilvinen kevyellä lumisateella
overcast with possible rain and fog= pilvinen mahdollisella sateella ja sumulla
overcast with possible rain= pilvinen mahdollisella sateella
overcast with rain and fog= pilvinen sateella ja sumulla
overcast with rain mixed with snow= pilvinen sateella sekoitettuna lumeen
overcast with rain showers and fog= pilvinen sadekuuroilla ja sumulla
overcast with rain showers= pilvinen sadekuuroilla
overcast with rain= pilvinen sateella
overcast with round snow showers= pilvinen pyöreillä lumisateilla
overcast with sleet and fog= pilvinen räntäsateella ja sumulla
overcast with sleet= pilvinen räntäsateella
overcast with snow and fog= pilvinen lumisateella ja sumulla
overcast with snow showers and fog= pilvinen lumisateilla ja sumulla
overcast with snow showers= pilvinen lumisateilla
overcast with snow storms= pilvinen lumimyrskyillä
overcast with snow= pilvinen lumella
overcast= pilvinen
overcast= pilvinen
partly cloudy= osittain pilvinen
partly or partly cloudy with scattered haze= osittain tai osittain pilvinen hajanaisella usvalla
partly= osittain
possible= mahdollinen
precipitation= sade
precipitation= sade
rain= sade
reduced visibility due to fog banks= heikentynyt näkyvyys sumuisten alueiden vuoksi
round= pyöreä
scattered clouds and clearings= hajanaiset pilvet ja selkeät alueet
scattered clouds with drizzle= hajanaiset pilvet tihkusateella
scattered clouds with large clearings= hajanaiset pilvet suurilla selkeillä alueilla
scattered clouds with light rain= hajanaiset pilvet kevyellä sateella
scattered clouds with light snow= hajanaiset pilvet kevyellä lumisateella
scattered clouds with possible rain= hajanaiset pilvet mahdollisella sateella
scattered clouds with possible thunderstorms= hajanaiset pilvet mahdollisilla ukkosilla
scattered clouds with rain= hajanaiset pilvet sateella
scattered clouds with sleet= hajanaiset pilvet räntäsateella
severe thunderstorms and fog= voimakkaat ukkoset ja sumu
severe thunderstorms with hail= voimakkaat ukkoset rakeilla
severe thunderstorms= voimakkaat ukkoset
showers= sadekuurot
showers= sadekuurot
sky= taivas
sleet= räntä
sleets= räntäsateet
slight precipitation= lievä sade
slight= lievä
snow= lumi
some= jotkut
storms= myrskyt
strong= voimakas
thin high clouds= ohuet korkeita pilviä
thin= ohut
thunder= ukkonen
thunderstorm= ukkosmyrsky
to= jollekin
very cloudy or overcast with high clouds= erittäin pilvinen tai harmaa korkeilla pilvillä
very cloudy or overcast= erittäin pilvinen tai harmaa
very cloudy with rain and thunderstorms and fog= erittäin pilvinen sateella, ukkosilla ja sumulla
very cloudy with rain and thunderstorms= erittäin pilvinen sateella ja ukkosilla
very heavy rain, locally flooding= erittäin rankka sade, paikalliset tulvat
very= erittäin
visibility= näkyvyys
weather= sää
with= kanssa