almost clear=presque clair
broken=cassé
clear=clair
clear or partly cloudy=clair ou partiellement nuageux
clear with haze=clair avec brume
clear with light haze=clair avec légère brume
cloudy or very cloudy=nuageux ou très nuageux
cloudy with extensive haze=nuageux avec brume étendue
cloudy with local openings=nuageux avec éclaircies locales
fog=brouillard
foggy weather=temps brumeux
foggy weather and very low visibility=temps brumeux et visibilité très faible
freezing fog=brouillard glacé
gray sky due to low clouds=ciel gris à cause de nuages bas
half cloudy=partiellement nuageux
heavy rain=fortes pluies
heavy snow and fog=forte neige et brouillard
irregular clouds with heavy rain=nuages irréguliers avec fortes pluies
irregular clouds with possible thunderstorm=nuages irréguliers avec orage possible
irregular clouds with possible thunderstorms and fog=nuages irréguliers avec orages possibles et brouillard
irregular clouds with rain showers=nuages irréguliers avec averses de pluie
irregular clouds with snow=nuages irréguliers avec neige
irregular clouds with snow showers=nuages irréguliers avec averses de neige
irregular clouds with strong thunderstorm=nuages irréguliers avec fort orage
irregular clouds with thunderstorms=nuages irréguliers avec orages
irregular clouds with very heavy rain=nuages irréguliers avec très fortes pluies
low clouds with some clearings=nuages bas avec quelques éclaircies
mostly clear=principalement clair
no precipitation=pas de précipitations
overcast=couvert
overcast with drizzle=couvert avec bruine
overcast with drizzle and fog=couvert avec bruine et brouillard
overcast with freezing rain=couvert avec pluie glacée
overcast with heavy snow=couvert avec forte neige
overcast with heavy snow of a blizzard nature=couvert avec neige forte de nature tempête de neige
overcast with heavy snow of a blizzard nature and fog=couvert avec neige forte de nature tempête de neige et brouillard
overcast with light rain=couvert avec pluie légère
overcast with light rain and fog=couvert avec pluie légère et brouillard
overcast with light snow=couvert avec neige légère
overcast with light snow and fog=couvert avec neige légère et brouillard
overcast with possible rain=couvert avec pluie possible
overcast with possible rain and fog=couvert avec pluie possible et brouillard
overcast with rain=couvert avec pluie
overcast with rain and fog=couvert avec pluie et brouillard
overcast with rain mixed with snow=couvert avec pluie mélangée à de la neige
overcast with rain showers=couvert avec averses de pluie
overcast with rain showers and fog=couvert avec averses de pluie et brouillard
overcast with round snow showers=couvert avec averses de neige rondes
overcast with sleet=couvert avec pluie verglaçante
overcast with sleet and fog=couvert avec pluie verglaçante et brouillard
overcast with snow=couvert avec neige
overcast with snow and fog=couvert avec neige et brouillard
overcast with snow showers=couvert avec averses de neige
overcast with snow showers and fog=couvert avec averses de neige et brouillard
overcast with snow storms=couvert avec tempêtes de neige
partly cloudy=partiellement nuageux
partly or partly cloudy with scattered haze=partiellement ou partiellement nuageux avec brume éparse
precipitation=précipitations
rain=pluie
reduced visibility due to fog banks=visibilité réduite à cause des bancs de brouillard
scattered clouds and clearings=nuages épars et éclaircies
scattered clouds with drizzle=nuages épars avec bruine
scattered clouds with large clearings=nuages épars avec grandes éclaircies
scattered clouds with light rain=nuages épars avec pluie légère
scattered clouds with light snow=nuages épars avec neige légère
scattered clouds with possible rain=nuages épars avec pluie possible
scattered clouds with possible thunderstorms=nuages épars avec orages possibles
scattered clouds with rain=nuages épars avec pluie
scattered clouds with sleet=nuages épars avec pluie verglaçante
severe thunderstorms=orages violents
severe thunderstorms and fog=orages violents et brouillard
severe thunderstorms with hail=orages violents avec grêle
showers=averses
sleet=pluie verglaçante
slight precipitation=précipitations légères
snow=neige
thin high clouds=nuages fins et élevés
thunder=tonnerre
very cloudy or overcast=très nuageux ou couvert
very cloudy or overcast with high clouds=très nuageux ou couvert avec nuages élevés
very cloudy with rain and thunderstorms=très nuageux avec pluie et orages
very cloudy with rain and thunderstorms and fog=très nuageux avec pluie, orages et brouillard
very heavy rain, locally flooding=très fortes pluies, inondations locales