april=april
august=agustus
december=desember
february=februari
friday=jumat
january=januari
july=juli
june=juni
march=maret
may=mei
monday=senin
november=november
october=oktober
saturday=sabtu
september=september
sunday=minggu
thursday=kamis
tuesday=selasa
wednesday=rabu
almost clear=hampir cerah
almost=hampir
and=dan
broken=terputus
clear or partly cloudy=cerah atau sebagian berawan
clear with haze=cerah dengan kabut
clear with light haze=cerah dengan kabut ringan
clear=cerah
clearings=penyinaran
cloudy or very cloudy=berawan atau sangat berawan
cloudy with extensive haze=berawan dengan kabut tebal
cloudy with local openings=berawan dengan celah lokal
cloudy=berawan
drizzle=gerimis
due=karena
extensive=luas
flooding=bencana banjir
fog=kabut
foggy weather and very low visibility=cuaca berkabut dan visibilitas sangat rendah
foggy weather=cuaca berkabut
foggy=berkabut
freezing fog=kabut beku
freezing=beku
gray sky due to low clouds=langit abu-abu karena awan rendah
gray=abu-abu
hail=hail
half cloudy=setengah berawan
half=setengah
haze=kabut tipis
heavy rain=hujan lebat
heavy snow and fog=snow lebat dan kabut
heavy=berat
high=tinggi
irregular clouds with heavy rain=awan tak teratur dengan hujan lebat
irregular clouds with possible thunderstorm=awan tak teratur dengan kemungkinan badai petir
irregular clouds with possible thunderstorms and fog=awan tak teratur dengan kemungkinan badai petir dan kabut
irregular clouds with rain showers=awan tak teratur dengan hujan deras
irregular clouds with snow showers=awan tak teratur dengan hujan salju
irregular clouds with snow=awan tak teratur dengan salju
irregular clouds with strong thunderstorm=awan tak teratur dengan badai petir yang kuat
irregular clouds with thunderstorms=awan tak teratur dengan badai petir
irregular clouds with very heavy rain=awan tak teratur dengan hujan sangat lebat
irregular=tidak teratur
light=ringan
local=lokal
low clouds with some clearings=awan rendah dengan beberapa penyinaran
low=rendah
mostly clear=sebagian besar cerah
mostly=sebagian besar
no precipitation=tidak ada presipitasi
no=tidak
openings=celah
or=atau
overcast with drizzle and fog=berawan dengan gerimis dan kabut
overcast with drizzle=berawan dengan gerimis
overcast with freezing rain=berawan dengan hujan beku
overcast with heavy snow of a blizzard nature and fog=berawan dengan salju lebat seperti badai dan kabut
overcast with heavy snow of a blizzard nature=berawan dengan salju lebat seperti badai
overcast with heavy snow=berawan dengan salju lebat
overcast with light rain and fog=berawan dengan hujan ringan dan kabut
overcast with light rain=berawan dengan hujan ringan
overcast with light snow and fog=berawan dengan salju ringan dan kabut
overcast with light snow=berawan dengan salju ringan
overcast with possible rain and fog=berawan dengan kemungkinan hujan dan kabut
overcast with possible rain=berawan dengan kemungkinan hujan
overcast with rain and fog=berawan dengan hujan dan kabut
overcast with rain mixed with snow=berawan dengan hujan yang dicampur salju
overcast with rain showers and fog=berawan dengan hujan deras dan kabut
overcast with rain showers=berawan dengan hujan deras
overcast with rain=berawan dengan hujan
overcast with round snow showers=berawan dengan hujan salju bulat
overcast with sleet and fog=berawan dengan hujan es dan kabut
overcast with sleet=berawan dengan hujan es
overcast with snow and fog=berawan dengan salju dan kabut
overcast with snow showers and fog=berawan dengan hujan salju dan kabut
overcast with snow showers=berawan dengan hujan salju
overcast with snow storms=berawan dengan badai salju
overcast with snow=berawan dengan salju
overcast=berawan
partly cloudy=sebagian berawan
partly or partly cloudy with scattered haze=sebagian atau sebagian berawan dengan kabut tersebar
partly=sebagian
possible=kemungkinan
precipitation=presipitasi
rain=hujan
reduced visibility due to fog banks=visibilitas berkurang karena kabut tebal
round=bulat
scattered clouds and clearings=awan tersebar dan penyinaran
scattered clouds with drizzle=awan tersebar dengan gerimis
scattered clouds with large clearings=awan tersebar dengan penyinaran besar
scattered clouds with light rain=awan tersebar dengan hujan ringan
scattered clouds with light snow=awan tersebar dengan salju ringan
scattered clouds with possible rain=awan tersebar dengan kemungkinan hujan
scattered clouds with possible thunderstorms=awan tersebar dengan kemungkinan badai petir
scattered clouds with rain=awan tersebar dengan hujan
scattered clouds with sleet=awan tersebar dengan hujan es
severe thunderstorms and fog=badai petir hebat dan kabut
severe thunderstorms with hail=badai petir hebat dengan hujan es
severe thunderstorms=badai petir hebat
showers=gujan deras
sky=langit
sleet=hujan es
slight precipitation=presipitasi ringan
slight=ringan
snow=salju
some=beberapa
storms=badai
strong=kuat
thin high clouds=awan tinggi tipis
thin=tipis
thunder=guruh
thunderstorm=badai petir
to=ke
very cloudy or overcast with high clouds=sangat berawan atau berawan dengan awan tinggi
very cloudy or overcast=sangat berawan atau berawan
very cloudy with rain and thunderstorms and fog=sangat berawan dengan hujan dan badai petir dan kabut
very heavy rain, locally flooding=hujan sangat lebat, banjir lokal
very=sangat
visibility=visibilitas
weather=cuaca
with=dengan