almost clear=quasi sereno
broken=spezzato
clear=sereno
cloudy=nuvoloso
clear or partly cloudy=sereno o parzialmente nuvoloso
clear with haze=sereno con foschia
clear with light haze=sereno con leggera foschia
cloudy or very cloudy=nuvoloso o molto nuvoloso
cloudy with extensive haze=nuvoloso con foschia estesa
cloudy with local openings=nuvoloso con aperture locali
fog=nebbia
foggy weather=tempo nebbioso
foggy weather and very low visibility=tempo nebbioso e visibilità molto bassa
freezing fog=nebbia ghiacciata
gray sky due to low clouds=cielo grigio per nubi basse
half cloudy=mezzo nuvoloso
heavy rain=pioggia intensa
heavy snow and fog=neve intensa e nebbia
irregular clouds with heavy rain=nuvole irregolari con pioggia intensa
irregular clouds with possible thunderstorm=nuvole irregolari con possibile temporale
irregular clouds with possible thunderstorms and fog=nuvole irregolari con possibile temporale e nebbia
irregular clouds with rain showers=nuvole irregolari con rovesci di pioggia
irregular clouds with snow=nuvole irregolari con neve
irregular clouds with snow showers=nuvole irregolari con rovesci di neve
irregular clouds with strong thunderstorm=nuvole irregolari con forte temporale
irregular clouds with thunderstorms=nuvole irregolari con temporali
irregular clouds with very heavy rain=nuvole irregolari con pioggia molto intensa
low clouds with some clearings=nuvole basse con alcune schiarite
mostly=per lo piu
mostly clear=per lo più sereno
no precipitation=nessuna precipitazione
overcast=coperto
overcast with drizzle=coperto con pioggerella
overcast with drizzle and fog=coperto con pioggerella e nebbia
overcast with freezing rain=coperto con pioggia ghiacciata
overcast with heavy snow=coperto con neve intensa
overcast with heavy snow of a blizzard nature=coperto con neve intensa di natura bufera di neve
overcast with heavy snow of a blizzard nature and fog=coperto con neve intensa di natura bufera di neve e nebbia
overcast with light rain=coperto con pioggia leggera
overcast with light rain and fog=coperto con pioggia leggera e nebbia
overcast with light snow=coperto con neve leggera
overcast with light snow and fog=coperto con neve leggera e nebbia
overcast with possible rain=coperto con possibile pioggia
overcast with possible rain and fog=coperto con possibile pioggia e nebbia
overcast with rain=coperto con pioggia
overcast with rain and fog=coperto con pioggia e nebbia
overcast with rain mixed with snow=coperto con pioggia mista a neve
overcast with rain showers=coperto con rovesci di pioggia
overcast with rain showers and fog=coperto con rovesci di pioggia e nebbia
overcast with round snow showers=coperto con nevicate rotonde
overcast with sleet=coperto con nevischio
overcast with sleet and fog=coperto con nevischio e nebbia
overcast with snow=coperto con neve
overcast with snow and fog=coperto con neve e nebbia
overcast with snow showers=coperto con rovesci di neve
overcast with snow showers and fog=coperto con rovesci di neve e nebbia
overcast with snow storms=coperto con tempeste di neve
partly cloudy=parzialmente nuvoloso
partly or partly cloudy with scattered haze=parzialmente o parzialmente nuvoloso con foschia sparsa
precipitation=precipitazioni
rain=pioggia
reduced visibility due to fog banks=visibilità ridotta a causa di banchi di nebbia
scattered clouds and clearings=nuvole sparse e schiarite
scattered clouds with drizzle=nuvole sparse con pioggerella
scattered clouds with large clearings=nuvole sparse con grandi schiarite
scattered clouds with light rain=nuvole sparse con pioggia leggera
scattered clouds with light snow=nuvole sparse con neve leggera
scattered clouds with possible rain=nuvole sparse con possibile pioggia
scattered clouds with possible thunderstorms=nuvole sparse con possibili temporali
scattered clouds with rain=nuvole sparse con pioggia
scattered clouds with sleet=nuvole sparse con nevischio
severe thunderstorms=forti temporali
severe thunderstorms and fog=forti temporali e nebbia
severe thunderstorms with hail=forti temporali con grandine
showers=rovesci
sleet=nevischio
slight precipitation=precipitazioni leggere
snow=neve
thin high clouds=sottili nubi alte
thunder=tuoni
very cloudy or overcast=molto nuvoloso o coperto
very cloudy or overcast with high clouds=molto nuvoloso o coperto con nubi alte
very cloudy with rain and thunderstorms=molto nuvoloso con pioggia e temporali
very cloudy with rain and thunderstorms and fog=molto nuvoloso con pioggia e temporali e nebbia
very heavy rain, locally flooding=pioggia molto forte, localmente inondazioni
