April=April
August=Agustus
December=Desember
February=Februari
Friday=Jumat
January=Januari
July=Juli
June=Juni
March=Maret
May=Mei
Monday=Senin
November=November
October=Oktober
Saturday=Sabtu
September=September
Sunday=Minggu
Thursday=Kamis
Tuesday=Selasa
Wednesday=Rabu
almost clear= gandrīz skaidrs
almost= gandrīz
and= un
broken= salauzts
clear or partly cloudy= skaidrs vai daļēji mākoņains
clear with haze= skaidrs ar miglu
clear with light haze= skaidrs ar vieglu miglu
clear= skaidrs
clearings= skaidrojumi
cloudy or very cloudy= mākoņains vai ļoti mākoņains
cloudy with extensive haze= mākoņains ar plašu miglu
cloudy with local openings= mākoņains ar vietējiem atvērumiem
cloudy= mākoņains
drizzle= smidzinošs lietus
due= dēļ
extensive= plašs
flooding= plūdi
fog= migla
foggy weather and very low visibility= miglains laiks un ļoti zema redzamība
foggy weather= miglains laiks
foggy= miglains
freezing fog= sala migla
freezing= sasalst
gray sky due to low clouds= pelēks debesis zemu mākoņu dēļ
gray= pelēks
hail= krusa
half cloudy= puscienīgs
half= puse
haze= migla
heavy rain= smagas lietus
heavy snow and fog= smags sniegs un migla
heavy= smags
high= augsts
irregular clouds with heavy rain= neregulāri mākoņi ar smagiem lietus
irregular clouds with possible thunderstorm= neregulāri mākoņi ar iespējamu pērkona negaisu
irregular clouds with possible thunderstorms and fog= neregulāri mākoņi ar iespējamiem pērkona negaisiem un miglu
irregular clouds with rain showers= neregulāri mākoņi ar lietusgāzēm
irregular clouds with snow showers= neregulāri mākoņi ar sniega gāzēm
irregular clouds with snow= neregulāri mākoņi ar sniegu
irregular clouds with strong thunderstorm= neregulāri mākoņi ar stipru pērkona negaisu
irregular clouds with thunderstorms= neregulāri mākoņi ar pērkona negaisiem
irregular clouds with very heavy rain= neregulāri mākoņi ar ļoti smagiem lietus
irregular= neregulārs
light= viegls
local= vietējais
low clouds with some clearings= zemi mākoņi ar dažiem skaidrojumiem
low= zems
mostly clear= galvenokārt skaidrs
mostly= galvenokārt
no precipitation= nav nokrišņu
no= nav
openings= atvērumi
or= vai
overcast with drizzle and fog= pilnīgi mākoņains ar smidzinošu lietu un miglu
overcast with drizzle= pilnīgi mākoņains ar smidzinošu lietu
overcast with freezing rain= pilnīgi mākoņains ar sala lietu
overcast with heavy snow of a blizzard nature and fog= pilnīgi mākoņains ar smagu sniegu no sniega vētras rakstura un miglu
overcast with heavy snow of a blizzard nature= pilnīgi mākoņains ar smagu sniegu no sniega vētras rakstura
overcast with heavy snow= pilnīgi mākoņains ar smagu sniegu
overcast with light rain and fog= pilnīgi mākoņains ar vieglu lietu un miglu
overcast with light rain= pilnīgi mākoņains ar vieglu lietu
overcast with light snow and fog= pilnīgi mākoņains ar vieglu sniegu un miglu
overcast with light snow= pilnīgi mākoņains ar vieglu sniegu
overcast with possible rain and fog= pilnīgi mākoņains ar iespējamiem lietiem un miglu
overcast with possible rain= pilnīgi mākoņains ar iespējamiem lietiem
overcast with rain and fog= pilnīgi mākoņains ar lietu un miglu
overcast with rain mixed with snow= pilnīgi mākoņains ar lietu, sajauktu ar sniegu
overcast with rain showers and fog= pilnīgi mākoņains ar lietusgāzēm un miglu
overcast with rain showers= pilnīgi mākoņains ar lietusgāzēm
overcast with rain= pilnīgi mākoņains ar lietu
overcast with round snow showers= pilnīgi mākoņains ar apaļiem sniega gāzēm
overcast with sleet and fog= pilnīgi mākoņains ar lietus un miglu
overcast with sleet= pilnīgi mākoņains ar lietus
overcast with snow and fog= pilnīgi mākoņains ar sniegu un miglu
overcast with snow showers and fog= pilnīgi mākoņains ar sniega gāzēm un miglu
overcast with snow showers= pilnīgi mākoņains ar sniega gāzēm
overcast with snow storms= pilnīgi mākoņains ar sniega vētrām
overcast with snow= pilnīgi mākoņains ar sniegu
overcast= pilnīgi mākoņains
partly cloudy= daļēji mākoņains
partly or partly cloudy with scattered haze= daļēji vai daļēji mākoņains ar izkliedētu miglu
partly= daļēji
possible= iespējams
precipitation= nokrišņi
rain= lietus
reduced visibility due to fog banks= samazināta redzamība miglas aiztures dēļ
round= apaļš
scattered clouds and clearings= izkliedēti mākoņi un skaidrojumi
scattered clouds with drizzle= izkliedēti mākoņi ar smidzinošu lietu
scattered clouds with large clearings= izkliedēti mākoņi ar lieliem skaidrojumiem
scattered clouds with light rain= izkliedēti mākoņi ar vieglu lietu
scattered clouds with light snow= izkliedēti mākoņi ar vieglu sniegu
scattered clouds with possible rain= izkliedēti mākoņi ar iespējamiem lietiem
scattered clouds with possible thunderstorms= izkliedēti mākoņi ar iespējamiem pērkona negaisiem
scattered clouds with rain= izkliedēti mākoņi ar lietu
scattered clouds with sleet= izkliedēti mākoņi ar lietus
severe thunderstorms and fog= smagi pērkona negaisi un migla
severe thunderstorms with hail= smagi pērkona negaisi ar krusu
severe thunderstorms= smagi pērkona negaisi
showers= lietusgāzes
showers= lietusgāzes
sky= debesis
sleet= ledus lietus
slight precipitation= nelieli nokrišņi
slight= neliels
snow= sniegs
some= daži
storms= vētras
strong= spēcīgs
thin high clouds= plāni augsti mākoņi
thin= plāns
thunder= pērkona
thunderstorm= pērkona negaisi
to= uz
very cloudy or overcast with high clouds= ļoti mākoņains vai pilnīgi mākoņains ar augstiem mākoņiem
very cloudy or overcast= ļoti mākoņains vai pilnīgi mākoņains
very cloudy with rain and thunderstorms and fog= ļoti mākoņains ar lietu, pērkona negaisiem un miglu
very heavy rain, locally flooding= ļoti smags lietus, vietējie plūdi
very= ļoti
visibility= redzamība
weather= laika apstākļi
with= ar