April=Kwiecień
August=Sierpień
December=Grudzień
February=Luty
Friday=Piątek
January=Styczeń
July=Lipiec
June=Czerwiec
March=Marzec
May=Maj
Monday=Poniedziałek
November=Listopad
October=Październik
Saturday=Sobota
September=Wrzesień
Sunday=Niedziela
Thursday=Czwartek
Tuesday=Wtorek
Wednesday=Środa
almost clear= prawie czysto
almost= prawie
and= i
broken= uszkodzony
clear or partly cloudy= czysto lub częściowo pochmurno
clear with haze= czysto z mgłą
clear with light haze= czysto z lekką mgłą
clear= czysto
clearings= rozpogodzenia
cloudy or very cloudy= pochmurno lub bardzo pochmurno
cloudy with extensive haze= pochmurno z dużą mgłą
cloudy with local openings= pochmurno z lokalnymi przejaśnieniami
cloudy= pochmurno
drizzle= mżawka
due= z powodu
extensive= rozległy
flooding= powódź
fog= mgła
foggy weather and very low visibility= mglista pogoda i bardzo niska widoczność
foggy weather= mglista pogoda
foggy= mglisto
freezing fog= mroźna mgła
freezing= mroźno
gray sky due to low clouds= szare niebo z powodu niskich chmur
gray= szaro
hail= grad
half cloudy= półpochmurno
half= pół
haze= mgła
heavy rain= intensywne opady deszczu
heavy snow and fog= intensywne opady śniegu i mgła
heavy= intensywne
high= wysokie
irregular clouds with heavy rain= nieregularne chmury z intensywnym deszczem
irregular clouds with possible thunderstorm= nieregularne chmury z możliwością burzy
irregular clouds with possible thunderstorms and fog= nieregularne chmury z możliwością burz i mgłą
irregular clouds with rain showers= nieregularne chmury z opadami deszczu
irregular clouds with snow showers= nieregularne chmury z opadami śniegu
irregular clouds with snow= nieregularne chmury ze śniegiem
irregular clouds with strong thunderstorm= nieregularne chmury z silną burzą
irregular clouds with thunderstorms= nieregularne chmury z burzami
irregular clouds with very heavy rain= nieregularne chmury z bardzo intensywnymi opadami deszczu
irregular= nieregularne
light= lekkie
local= lokalne
low clouds with some clearings= niskie chmury z pewnymi rozpogodzeniami
low= niskie
mostly clear= głównie czysto
mostly= głównie
mostly= głównie
no precipitation= brak opadów
no= nie
openings= przejaśnienia
or= lub
overcast with drizzle and fog= pochmurno z mżawką i mgłą
overcast with drizzle= pochmurno z mżawką
overcast with freezing rain= pochmurno z mroźnym deszczem
overcast with heavy snow of a blizzard nature and fog= pochmurno z intensywnym śniegiem o charakterze burzy śnieżnej i mgłą
overcast with heavy snow of a blizzard nature= pochmurno z intensywnym śniegiem o charakterze burzy śnieżnej
overcast with heavy snow= pochmurno z intensywnym śniegiem
overcast with light rain and fog= pochmurno z lekkim deszczem i mgłą
overcast with light rain= pochmurno z lekkim deszczem
overcast with light snow and fog= pochmurno z lekkim śniegiem i mgłą
overcast with light snow= pochmurno z lekkim śniegiem
overcast with possible rain and fog= pochmurno z możliwością deszczu i mgłą
overcast with possible rain= pochmurno z możliwością deszczu
overcast with rain and fog= pochmurno z deszczem i mgłą
overcast with rain mixed with snow= pochmurno z deszczem mieszanym ze śniegiem
overcast with rain showers and fog= pochmurno z opadami deszczu i mgłą
overcast with rain showers= pochmurno z opadami deszczu
overcast with rain= pochmurno z deszczem
overcast with round snow showers= pochmurno z okrągłymi opadami śniegu
overcast with sleet and fog= pochmurno z deszczem lodowym i mgłą
overcast with sleet= pochmurno z deszczem lodowym
overcast with snow and fog= pochmurno ze śniegiem i mgłą
overcast with snow showers and fog= pochmurno z opadami śniegu i mgłą
overcast with snow showers= pochmurno z opadami śniegu
overcast with snow storms= pochmurno z burzami śnieżnymi
overcast with snow= pochmurno ze śniegiem
overcast= pochmurno
overcast= pochmurno
partly cloudy= częściowo pochmurno
partly or partly cloudy with scattered haze= częściowo lub częściowo pochmurno z rozproszoną mgłą
partly= częściowo
possible= możliwe
precipitation= opady
precipitation= opady
rain= deszcz
reduced visibility due to fog banks= zmniejszona widoczność z powodu mgły
round= okrągłe
scattered clouds and clearings= rozproszone chmury i przejaśnienia
scattered clouds with drizzle= rozproszone chmury z mżawką
scattered clouds with large clearings= rozproszone chmury z dużymi przejaśnieniami
scattered clouds with light rain= rozproszone chmury z lekkim deszczem
scattered clouds with light snow= rozproszone chmury z lekkim śniegiem
scattered clouds with possible rain= rozproszone chmury z możliwością deszczu
scattered clouds with possible thunderstorms= rozproszone chmury z możliwością burz
scattered clouds with rain= rozproszone chmury z deszczem
scattered clouds with sleet= rozproszone chmury z deszczem lodowym
severe thunderstorms and fog= poważne burze i mgła
severe thunderstorms with hail= poważne burze z gradem
severe thunderstorms= poważne burze
showers= opady
showers= opady
sky= niebo
sleet= deszcz lodowy
sleets= deszcze lodowe
slight precipitation= niewielkie opady
slight= niewielki
snow= śnieg
some= trochę
storms= burze
strong= silny
thin high clouds= cienkie chmury wysokie
thin= cienki
thunder= grzmot
thunderstorm= burza
to= do
very cloudy or overcast with high clouds= bardzo pochmurno lub pochmurno z wysokimi chmurami
very cloudy or overcast= bardzo pochmurno lub pochmurno
very cloudy with rain and thunderstorms and fog= bardzo pochmurno z deszczem, burzami i mgłą
very cloudy with rain and thunderstorms= bardzo pochmurno z deszczem i burzami
very heavy rain, locally flooding= bardzo intensywne opady deszczu, lokalne powodzie
very= bardzo
visibility= widoczność
weather= pogoda
with= z