almost clear= quase claro
almost= quase
and= e
broken= quebrado
clear or partly cloudy= claro ou parcialmente nublado
clear with haze= claro com névoa
clear with light haze= claro com leve névoa
clear= claro
clearings= aberturas
cloudy or very cloudy= nublado ou muito nublado
cloudy with extensive haze= nublado com névoa extensa
cloudy with local openings= nublado com aberturas locais
cloudy= nublado
drizzle= garoa
due= devido
extensive= extenso
flooding= inundação
fog= neblina
foggy weather and very low visibility= tempo com neblina e visibilidade muito baixa
foggy weather= tempo com neblina
foggy= nebuloso
freezing fog= neblina congelante
freezing= congelante
gray sky due to low clouds= céu cinza devido a nuvens baixas
gray= cinza
hail= granizo
half cloudy= meio nublado
half= metade
haze= névoa
heavy rain= chuva forte
heavy snow and fog= neve forte e neblina
heavy= pesado
high= alto
irregular clouds with heavy rain= nuvens irregulares com chuva forte
irregular clouds with possible thunderstorm= nuvens irregulares com possível tempestade
irregular clouds with possible thunderstorms and fog= nuvens irregulares com possíveis tempestades e neblina
irregular clouds with rain showers= nuvens irregulares com chuvas
irregular clouds with snow showers= nuvens irregulares com chuvas de neve
irregular clouds with snow= nuvens irregulares com neve
irregular clouds with strong thunderstorm= nuvens irregulares com tempestade forte
irregular clouds with thunderstorms= nuvens irregulares com tempestades
irregular clouds with very heavy rain= nuvens irregulares com chuva muito forte
irregular= irregular
light= leve
local= local
low clouds with some clearings= nuvens baixas com algumas aberturas
low= baixo
mostly clear= quase claro
mostly= principalmente
mostly= principalmente
no precipitation= sem precipitação
no= não
openings= aberturas
or= ou
overcast with drizzle and fog= nublado com garoa e neblina
overcast with drizzle= nublado com garoa
overcast with freezing rain= nublado com chuva congelante
overcast with heavy snow of a blizzard nature and fog= nublado com neve forte de natureza de tormenta de neve e neblina
overcast with heavy snow of a blizzard nature= nublado com neve forte de natureza de tormenta de neve
overcast with heavy snow= nublado com neve forte
overcast with light rain and fog= nublado com chuva leve e neblina
overcast with light rain= nublado com chuva leve
overcast with light snow and fog= nublado com neve leve e neblina
overcast with light snow= nublado com neve leve
overcast with possible rain and fog= nublado com possível chuva e neblina
overcast with possible rain= nublado com possível chuva
overcast with rain and fog= nublado com chuva e neblina
overcast with rain mixed with snow= nublado com chuva misturada com neve
overcast with rain showers and fog= nublado com chuvas e neblina
overcast with rain showers= nublado com chuvas
overcast with rain= nublado com chuva
overcast with round snow showers= nublado com chuvas de neve redondas
overcast with sleet and fog= nublado com granizo e neblina
overcast with sleet= nublado com granizo
overcast with snow and fog= nublado com neve e neblina
overcast with snow showers and fog= nublado com chuvas de neve e neblina
overcast with snow showers= nublado com chuvas de neve
overcast with snow storms= nublado com tempestades de neve
overcast with snow= nublado com neve
overcast= nublado
overcast= nublado
partly cloudy= parcialmente nublado
partly or partly cloudy with scattered haze= parcialmente ou parcialmente nublado com névoa dispersa
partly= parcialmente
possible= possível
precipitation= precipitação
precipitation= precipitação
rain= chuva
reduced visibility due to fog banks= visibilidade reduzida devido a nevoeiro
round= redondo
scattered clouds and clearings= nuvens dispersas e aberturas
scattered clouds with drizzle= nuvens dispersas com garoa
scattered clouds with large clearings= nuvens dispersas com grandes aberturas
scattered clouds with light rain= nuvens dispersas com chuva leve
scattered clouds with light snow= nuvens dispersas com neve leve
scattered clouds with possible rain= nuvens dispersas com possível chuva
scattered clouds with possible thunderstorms= nuvens dispersas com possíveis tempestades
scattered clouds with rain= nuvens dispersas com chuva
scattered clouds with sleet= nuvens dispersas com granizo
severe thunderstorms and fog= tempestades severas e neblina
severe thunderstorms with hail= tempestades severas com granizo
severe thunderstorms= tempestades severas
showers= chuvas
showers= chuvas
sky= céu
sleet= granizo
sleets= granizos
slight precipitation= precipitação leve
slight= leve
snow= neve
some= algum
storms= tempestades
strong= forte
thin high clouds= nuvens altas e finas
thin= fino
thunder= trovão
thunderstorm= tempestade
to= para
very cloudy or overcast with high clouds= muito nublado ou nublado com nuvens altas
very cloudy or overcast= muito nublado ou nublado
very cloudy with rain and thunderstorms and fog= muito nublado com chuva, tempestades e neblina
very cloudy with rain and thunderstorms= muito nublado com chuva e tempestades
very heavy rain, locally flooding= chuvas muito fortes, com inundações locais
very= muito
visibility= visibilidade
weather= clima
with= com
