almost clear=почти ясно
broken=разорвано
clear=ясно
clear or partly cloudy=ясно или частично облачно
clear with haze=ясно с дымкой
clear with light haze=ясно с легкой дымкой
cloudy or very cloudy=облачно или очень облачно
cloudy with extensive haze=облачно с сильной дымкой
cloudy with local openings=облачно с местными прояснениями
fog=туман
foggy weather=туманная погода
foggy weather and very low visibility=туманная погода и очень низкая видимость
freezing fog=замерзающий туман
gray sky due to low clouds=серое небо из-за низких облаков
half cloudy=полупасмурно
heavy rain=сильный дождь
heavy snow and fog=сильный снег и туман
irregular clouds with heavy rain=неравномерные облака с сильным дождем
irregular clouds with possible thunderstorm=неравномерные облака с возможной грозой
irregular clouds with possible thunderstorms and fog=неравномерные облака с возможными грозами и туманом
irregular clouds with rain showers=неравномерные облака с дождевыми ливнями
irregular clouds with snow=неравномерные облака со снегом
irregular clouds with snow showers=неравномерные облака со снежными ливнями
irregular clouds with strong thunderstorm=неравномерные облака с сильной грозой
irregular clouds with thunderstorms=неравномерные облака с грозами
irregular clouds with very heavy rain=неравномерные облака с очень сильным дождем
low clouds with some clearings=низкие облака с некоторыми прояснениями
mostly clear=в основном ясно
no precipitation=без осадков
overcast=пасмурно
overcast with drizzle=пасмурно с моросящим дождем
overcast with drizzle and fog=пасмурно с моросящим дождем и туманом
overcast with freezing rain=пасмурно с замерзающим дождем
overcast with heavy snow=пасмурно с сильным снегом
overcast with heavy snow of a blizzard nature=пасмурно с сильным снегом, снежная буря
overcast with heavy snow of a blizzard nature and fog=пасмурно с сильным снегом, снежная буря и туман
overcast with light rain=пасмурно с легким дождем
overcast with light rain and fog=пасмурно с легким дождем и туманом
overcast with light snow=пасмурно с легким снегом
overcast with light snow and fog=пасмурно с легким снегом и туманом
overcast with possible rain=пасмурно с возможным дождем
overcast with possible rain and fog=пасмурно с возможным дождем и туманом
overcast with rain=пасмурно с дождем
overcast with rain and fog=пасмурно с дождем и туманом
overcast with rain mixed with snow=пасмурно с дождем, смешанным со снегом
overcast with rain showers=пасмурно с дождевыми ливнями
overcast with rain showers and fog=пасмурно с дождевыми ливнями и туманом
overcast with round snow showers=пасмурно с круглыми снежными ливнями
overcast with sleet=пасмурно с дождем и снегом
overcast with sleet and fog=пасмурно с дождем и снегом и туманом
overcast with snow=пасмурно со снегом
overcast with snow and fog=пасмурно со снегом и туманом
overcast with snow showers=пасмурно с снежными ливнями
overcast with snow showers and fog=пасмурно с снежными ливнями и туманом
overcast with snow storms=пасмурно с снежными бурями
partly cloudy=частично облачно
partly or partly cloudy with scattered haze=частично или частично облачно с рассеянной дымкой
precipitation=осадки
rain=дождь
reduced visibility due to fog banks=сниженная видимость из-за туманной завесы
scattered clouds and clearings=рассеянные облака и прояснения
scattered clouds with drizzle=рассеянные облака с моросящим дождем
scattered clouds with large clearings=рассеянные облака с большими прояснениями
scattered clouds with light rain=рассеянные облака с легким дождем
scattered clouds with light snow=рассеянные облака с легким снегом
scattered clouds with possible rain=рассеянные облака с возможным дождем
scattered clouds with possible thunderstorms=рассеянные облака с возможными грозами
scattered clouds with rain=рассеянные облака с дождем
scattered clouds with sleet=рассеянные облака с дождем и снегом
severe thunderstorms=сильные грозы
severe thunderstorms and fog=сильные грозы и туман
severe thunderstorms with hail=сильные грозы с градом
showers=ливни
sleet=дождь с снегом
slight precipitation=незначительные осадки
snow=снег
thin high clouds=тонкие высокие облака
thunder=гром
very cloudy or overcast=очень облачно или пасмурно
very cloudy or overcast with high clouds=очень облачно или пасмурно с высокими облаками
very cloudy with rain and thunderstorms=очень облачно с дождем и грозами
very cloudy with rain and thunderstorms and fog=очень облачно с дождем, грозами и туманом
very heavy rain, locally flooding=очень сильный дождь, местные наводнения