april=apríl
august=august
december=december
february=február
friday=piatok
january=január
july=júl
june=jún
march=marec
may=máj
monday=pondelok
november=november
october=október
saturday=sobota
september=september
sunday=nedeľa
thursday=štvrtok
tuesday=utorok
wednesday=streda
almost clear= takmer jasné
almost= takmer
and= a
broken= zlomené
clear or partly cloudy= jasné alebo čiastočne oblačné
clear with haze= jasné s hmlou
clear with light haze= jasné s jemnou hmlou
clear= jasné
clearings= jasné miesta
cloudy or very cloudy= oblačné alebo veľmi oblačné
cloudy with extensive haze= oblačné s rozsiahlym oparom
cloudy with local openings= oblačné s miestnymi otvormi
cloudy= oblačné
drizzle= mrholenie
due= kvôli
extensive= rozsiahle
flooding= povodeň
fog= hmla
foggy weather and very low visibility= hmlisté počasie a veľmi nízka viditeľnosť
foggy weather= hmlisté počasie
foggy= hmlisté
freezing fog= zamrznutá hmla
freezing= zamrznuté
gray sky due to low clouds= šedá obloha kvôli nízkym mrakom
gray= šedá
hail= krúpy
half cloudy= polojasné
half= polovičné
haze= opar
heavy rain= silný dážď
heavy snow and fog= silný sneh a hmla
heavy= silný
high= vysoký
irregular clouds with heavy rain= nepravidelné oblaky so silným dažďom
irregular clouds with possible thunderstorm= nepravidelné oblaky s možnou búrkou
irregular clouds with possible thunderstorms and fog= nepravidelné oblaky s možnými búrkami a hmlou
irregular clouds with rain showers= nepravidelné oblaky s prehánkami
irregular clouds with snow showers= nepravidelné oblaky so snehovými prehánkami
irregular clouds with snow= nepravidelné oblaky so snehom
irregular clouds with strong thunderstorm= nepravidelné oblaky s silnou búrkou
irregular clouds with thunderstorms= nepravidelné oblaky s búrkami
irregular clouds with very heavy rain= nepravidelné oblaky so silným dažďom
irregular= nepravidelné
light= ľahký
local= miestny
low clouds with some clearings= nízke mraky s niektorými jasnými miestami
low= nízky
mostly clear= prevažne jasné
mostly= prevažne
mostly= prevažne
no precipitation= žiadne zrážky
no= nie
openings= otvory
or= alebo
overcast with drizzle and fog= zamračené s mrholením a hmlou
overcast with drizzle= zamračené s mrholením
overcast with freezing rain= zamračené so zamrznutým dažďom
overcast with heavy snow of a blizzard nature and fog= zamračené so silným snehom blizzardového charakteru a hmlou
overcast with heavy snow of a blizzard nature= zamračené so silným snehom blizzardového charakteru
overcast with heavy snow= zamračené so silným snehom
overcast with light rain and fog= zamračené s ľahkým dažďom a hmlou
overcast with light rain= zamračené s ľahkým dažďom
overcast with light snow and fog= zamračené s ľahkým snehom a hmlou
overcast with light snow= zamračené s ľahkým snehom
overcast with possible rain and fog= zamračené s možným dažďom a hmlou
overcast with possible rain= zamračené s možným dažďom
overcast with rain and fog= zamračené s dažďom a hmlou
overcast with rain mixed with snow= zamračené s dažďom zmiešaným so snehom
overcast with rain showers and fog= zamračené s prehánkami a hmlou
overcast with rain showers= zamračené s prehánkami
overcast with rain= zamračené s dažďom
overcast with round snow showers= zamračené s okrúhlymi snehovými prehánkami
overcast with sleet and fog= zamračené so snežením a hmlou
overcast with sleet= zamračené so snežením
overcast with snow and fog= zamračené so snehom a hmlou
overcast with snow showers and fog= zamračené so snehovými prehánkami a hmlou
overcast with snow showers= zamračené so snehovými prehánkami
overcast with snow storms= zamračené so snehovými búrkami
overcast with snow= zamračené so snehom
overcast= zamračené
overcast= zamračené
partly cloudy= čiastočne oblačné
partly or partly cloudy with scattered haze= čiastočne alebo čiastočne oblačné s rozptýleným opárom
partly= čiastočne
possible= možné
precipitation= zrážky
precipitation= zrážky
rain= dážď
reduced visibility due to fog banks= znížená viditeľnosť kvôli hmle
round= okrúhle
scattered clouds and clearings= rozptýlené oblaky a jasné miesta
scattered clouds with drizzle= rozptýlené oblaky s mrholením
scattered clouds with large clearings= rozptýlené oblaky s veľkými jasnými miestami
scattered clouds with light rain= rozptýlené oblaky s ľahkým dažďom
scattered clouds with light snow= rozptýlené oblaky s ľahkým snehom
scattered clouds with possible rain= rozptýlené oblaky s možným dažďom
scattered clouds with possible thunderstorms= rozptýlené oblaky s možnými búrkami
scattered clouds with rain= rozptýlené oblaky s dažďom
scattered clouds with sleet= rozptýlené oblaky so snežením
severe thunderstorms and fog= silné búrky a hmla
severe thunderstorms with hail= silné búrky s krúpami
severe thunderstorms= silné búrky
showers= prehánky
showers= prehánky
sky= obloha
sleet= sneženie
sleets= sneženia
slight precipitation= slabé zrážky
slight= slabý
snow= sneh
some= niektoré
storms= búrky
strong= silný
thin high clouds= tenké vysoké oblaky
thin= tenký
thunder= hrom
thunderstorm= búrka
to= do
very cloudy or overcast with high clouds= veľmi oblačné alebo zamračené s vysokými oblakmi
very cloudy or overcast= veľmi oblačné alebo zamračené
very cloudy with rain and thunderstorms and fog= veľmi oblačné s dažďom, búrkami a hmlou
very cloudy with rain and thunderstorms= veľmi oblačné s dažďom a búrkami
very heavy rain, locally flooding= veľmi silný dážď, miestne záplavy
very= veľmi
visibility= viditeľnosť
weather= počasie
with= s