April=April
August=Augusti
December=December
February=Februari
Friday=Fredag
January=Januari
July=Juli
June=Juni
March=Mars
May=Maj
Monday=Måndag
November=November
October=Oktober
Saturday=Lördag
September=September
Sunday=Söndag
Thursday=Torsdag
Tuesday=Tisdag
Wednesday=Onsdag
almost clear= nästan klar
almost= nästan
and= och
broken= trasig
clear or partly cloudy= klart eller delvis molnigt
clear with haze= klart med dis
clear with light haze= klart med lätt dis
clear= klart
clearings= gläntor
cloudy or very cloudy= molnigt eller mycket molnigt
cloudy with extensive haze= molnigt med omfattande dis
cloudy with local openings= molnigt med lokala öppningar
cloudy= molnigt
drizzle= duggregn
due= på grund av
extensive= omfattande
flooding= översvämningar
fog= dimma
foggy weather and very low visibility= dimmigt väder och mycket låg sikt
foggy weather= dimmigt väder
foggy= dimmigt
freezing fog= fryst dimma
freezing= fryser
gray sky due to low clouds= grå himmel på grund av låga moln
gray= grå
hail= hagel
half cloudy= halv molnigt
half= halv
haze= dis
heavy rain= kraftigt regn
heavy snow and fog= kraftigt snöfall och dimma
heavy= tung
high= hög
irregular clouds with heavy rain= oregelbundna moln med kraftigt regn
irregular clouds with possible thunderstorm= oregelbundna moln med möjligt åskväder
irregular clouds with possible thunderstorms and fog= oregelbundna moln med möjliga åskstormar och dimma
irregular clouds with rain showers= oregelbundna moln med regnskurar
irregular clouds with snow showers= oregelbundna moln med snöbyar
irregular clouds with snow= oregelbundna moln med snö
irregular clouds with strong thunderstorm= oregelbundna moln med kraftigt åskväder
irregular clouds with thunderstorms= oregelbundna moln med åskväder
irregular clouds with very heavy rain= oregelbundna moln med mycket kraftigt regn
irregular= oregelbundet
light= lätt
local= lokal
low clouds with some clearings= låga moln med några gläntor
low= låg
mostly clear= mestadels klart
mostly= mestadels
mostly= mestadels
no precipitation= inget nederbörd
no= nej
openings= öppningar
or= eller
overcast with drizzle and fog= övercast med duggregn och dimma
overcast with drizzle= övercast med duggregn
overcast with freezing rain= övercast med isregn
overcast with heavy snow of a blizzard nature and fog= övercast med kraftigt snöfall av snöstormnatur och dimma
overcast with heavy snow of a blizzard nature= övercast med kraftigt snöfall av snöstormnatur
overcast with heavy snow= övercast med kraftigt snöfall
overcast with light rain and fog= övercast med lätt regn och dimma
overcast with light rain= övercast med lätt regn
overcast with light snow and fog= övercast med lätt snö och dimma
overcast with light snow= övercast med lätt snö
overcast with possible rain and fog= övercast med möjligt regn och dimma
overcast with possible rain= övercast med möjligt regn
overcast with rain and fog= övercast med regn och dimma
overcast with rain mixed with snow= övercast med regn blandat med snö
overcast with rain showers and fog= övercast med regnskurar och dimma
overcast with rain showers= övercast med regnskurar
overcast with rain= övercast med regn
overcast with round snow showers= övercast med runda snöbyar
overcast with sleet and fog= övercast med snöblandat regn och dimma
overcast with sleet= övercast med snöblandat regn
overcast with snow and fog= övercast med snö och dimma
overcast with snow showers and fog= övercast med snöbyar och dimma
overcast with snow showers= övercast med snöbyar
overcast with snow storms= övercast med snöstormar
overcast with snow= övercast med snö
overcast= övercast
overcast= övercast
partly cloudy= delvis molnigt
partly or partly cloudy with scattered haze= delvis eller delvis molnigt med utspritt dis
partly= delvis
possible= möjlig
precipitation= nederbörd
precipitation= nederbörd
rain= regn
reduced visibility due to fog banks= reducerad sikt på grund av dimbankar
round= rund
scattered clouds and clearings= utspridda moln och gläntor
scattered clouds with drizzle= utspridda moln med duggregn
scattered clouds with large clearings= utspridda moln med stora gläntor
scattered clouds with light rain= utspridda moln med lätt regn
scattered clouds with light snow= utspridda moln med lätt snö
scattered clouds with possible rain= utspridda moln med möjligt regn
scattered clouds with possible thunderstorms= utspridda moln med möjliga åskväder
scattered clouds with rain= utspridda moln med regn
scattered clouds with sleet= utspridda moln med snöblandat regn
severe thunderstorms and fog= svåra åskväder och dimma
severe thunderstorms with hail= svåra åskväder med hagel
severe thunderstorms= svåra åskväder
showers= regnskurar
showers= regnskurar
sky= himmel
sleet= snöblandat regn
sleets= snöblandat regn
slight precipitation= lätt nederbörd
slight= lätt
snow= snö
some= några
storms= stormar
strong= stark
thin high clouds= tunna höga moln
thin= tunn
thunder= åska
thunderstorm= åskstorm
to= till
very cloudy or overcast with high clouds= mycket molnigt eller övercast med höga moln
very cloudy or overcast= mycket molnigt eller övercast
very cloudy with rain and thunderstorms and fog= mycket molnigt med regn, åskstormar och dimma
very cloudy with rain and thunderstorms= mycket molnigt med regn och åskstormar
very heavy rain, locally flooding= mycket kraftigt regn, lokala översvämningar
very= mycket
visibility= sikt
weather= väder
with= med