april=nisan
august=ağustos
december=aralık
february=şubat
friday=cuma
january=ocak
july=temmuz
june=haziran
march=mart
may=mayıs
monday=pazartesi
november=kasım
october=ekim
saturday=cumartesi
september=eylül
sunday=pazar
thursday=perşembe
tuesday=salı
wednesday=çarşamba
almost clear= neredeyse açık
almost= neredeyse
and= ve
broken= kırık
clear or partly cloudy= açık veya parçalı bulutlu
clear with haze= açık ve puslu
clear with light haze= açık ve hafif puslu
clear= açık
clearings= açıklıklar
cloudy or very cloudy= bulutlu veya çok bulutlu
cloudy with extensive haze= bulutlu ve yoğun puslu
cloudy with local openings= bulutlu ve yerel açıklıklar
cloudy= bulutlu
drizzle= çiseleyen yağmur
due= nedeniyle
extensive= geniş
flooding= sel
fog= sis
foggy weather and very low visibility= sisli hava ve çok düşük görüş mesafesi
foggy weather= sisli hava
foggy= sisli
freezing fog= donmuş sis
freezing= donma
gray sky due to low clouds= düşük bulutlardan dolayı gri gökyüzü
gray= gri
hail= dolu
half cloudy= yarı bulutlu
half= yarım
haze= pus
heavy rain= şiddetli yağmur
heavy snow and fog= yoğun kar ve sis
heavy= ağır
high= yüksek
irregular clouds with heavy rain= düzensiz bulutlar ve şiddetli yağmur
irregular clouds with possible thunderstorm= düzensiz bulutlar ve olası gök gürültülü fırtına
irregular clouds with possible thunderstorms and fog= düzensiz bulutlar, olası gök gürültülü fırtına ve sis
irregular clouds with rain showers= düzensiz bulutlar ve yağmur sağanakları
irregular clouds with snow showers= düzensiz bulutlar ve kar sağanakları
irregular clouds with snow= düzensiz bulutlar ve kar
irregular clouds with strong thunderstorm= düzensiz bulutlar ve güçlü gök gürültülü fırtına
irregular clouds with thunderstorms= düzensiz bulutlar ve gök gürültülü fırtınalar
irregular clouds with very heavy rain= düzensiz bulutlar ve çok şiddetli yağmur
irregular= düzensiz
light= hafif
local= yerel
low clouds with some clearings= düşük bulutlar ve bazı açıklıklar
low= düşük
mostly clear= çoğunlukla açık
mostly= çoğunlukla
mostly= çoğunlukla
no precipitation= yağış yok
no= hayır
openings= açıklıklar
or= veya
overcast with drizzle and fog= kapalı hava, çiseleyen yağmur ve sis
overcast with drizzle= kapalı hava ve çiseleyen yağmur
overcast with freezing rain= kapalı hava ve donmuş yağmur
overcast with heavy snow of a blizzard nature and fog= kapalı hava ve tipi tarzında yoğun kar ile sis
overcast with heavy snow of a blizzard nature= kapalı hava ve tipi tarzında yoğun kar
overcast with heavy snow= kapalı hava ve yoğun kar
overcast with light rain and fog= kapalı hava ve hafif yağmur ve sis
overcast with light rain= kapalı hava ve hafif yağmur
overcast with light snow and fog= kapalı hava ve hafif kar ve sis
overcast with light snow= kapalı hava ve hafif kar
overcast with possible rain and fog= kapalı hava ve olası yağmur ve sis
overcast with possible rain= kapalı hava ve olası yağmur
overcast with rain and fog= kapalı hava ve yağmur ve sis
overcast with rain mixed with snow= kapalı hava ve yağmur ile kar karışımı
overcast with rain showers and fog= kapalı hava ve yağmur sağanakları ve sis
overcast with rain showers= kapalı hava ve yağmur sağanakları
overcast with rain= kapalı hava ve yağmur
overcast with round snow showers= kapalı hava ve yuvarlak kar sağanakları
overcast with sleet and fog= kapalı hava ve karla karışık yağmur ve sis
overcast with sleet= kapalı hava ve karla karışık yağmur
overcast with snow and fog= kapalı hava ve kar ve sis
overcast with snow showers and fog= kapalı hava ve kar sağanakları ve sis
overcast with snow showers= kapalı hava ve kar sağanakları
overcast with snow storms= kapalı hava ve kar fırtınaları
overcast with snow= kapalı hava ve kar
overcast= kapalı
overcast= kapalı
partly cloudy= parçalı bulutlu
partly or partly cloudy with scattered haze= parçalı veya parçalı bulutlu ve dağılmış pus
partly= kısmen
possible= olası
precipitation= yağış
precipitation= yağış
rain= yağmur
reduced visibility due to fog banks= sis bankaları nedeniyle azalmış görüş mesafesi
round= yuvarlak
scattered clouds and clearings= dağılmış bulutlar ve açıklıklar
scattered clouds with drizzle= dağılmış bulutlar ve çiseleyen yağmur
scattered clouds with large clearings= dağılmış bulutlar ve büyük açıklıklar
scattered clouds with light rain= dağılmış bulutlar ve hafif yağmur
scattered clouds with light snow= dağılmış bulutlar ve hafif kar
scattered clouds with possible rain= dağılmış bulutlar ve olası yağmur
scattered clouds with possible thunderstorms= dağılmış bulutlar ve olası gök gürültülü fırtınalar
scattered clouds with rain= dağılmış bulutlar ve yağmur
scattered clouds with sleet= dağılmış bulutlar ve karla karışık yağmur
severe thunderstorms and fog= şiddetli gök gürültülü fırtınalar ve sis
severe thunderstorms with hail= şiddetli gök gürültülü fırtınalar ve dolu
severe thunderstorms= şiddetli gök gürültülü fırtınalar
showers= sağanak yağmur
showers= sağanak yağmur
sky= gökyüzü
sleet= karla karışık yağmur
sleets= karla karışık yağmur
slight precipitation= hafif yağış
slight= hafif
snow= kar
some= bazı
storms= fırtınalar
strong= güçlü
thin high clouds= ince yüksek bulutlar
thin= ince
thunder= gök gürültüsü
thunderstorm= gök gürültülü fırtına
to= için
very cloudy or overcast with high clouds= çok bulutlu veya kapalı hava ve yüksek bulutlar
very cloudy or overcast= çok bulutlu veya kapalı hava
very cloudy with rain and thunderstorms and fog= çok bulutlu ve yağmur, gök gürültülü fırtınalar ve sis
very cloudy with rain and thunderstorms= çok bulutlu ve yağmur ve gök gürültülü fırtınalar
very heavy rain, locally flooding= çok şiddetli yağmur, yerel sel
very= çok
visibility= görüş mesafesi
weather= hava
with= ile