april=四月
august=八月
december=十二月
february=二月
friday=星期五
january=一月
july=七月
june=六月
march=三月
may=五月
monday=星期一
november=十一月
october=十月
saturday=星期六
september=九月
sunday=星期天
thursday=星期四
tuesday=星期二
wednesday=星期三
almost clear=几乎清晰
almost=几乎
and=和
broken=破碎
clear or partly cloudy=清晰或部分多云
clear with haze=有雾霾的清晰
clear with light haze=轻度雾霾的清晰
clear=清晰
clearings=开阔区域
cloudy or very cloudy=多云或非常多云
cloudy with extensive haze=有广泛雾霾的多云
cloudy with local openings=局部开阔的多云
cloudy=多云
drizzle=细雨
due=由于
extensive=广泛的
flooding=洪水
fog=雾
foggy weather and very low visibility=雾霾天气和极低能见度
foggy weather=雾霾天气
foggy=有雾的
freezing fog=结冰雾
freezing=结冰的
gray sky due to low clouds=由于低云而灰暗的天空
gray=灰色的
hail=冰雹
half cloudy=半多云
half=一半
haze=雾霾
heavy rain=大雨
heavy snow and fog=大雪和雾
heavy=重的
high=高的
irregular clouds with heavy rain=不规则云层带大雨
irregular clouds with possible thunderstorm=不规则云层带有可能的雷暴
irregular clouds with possible thunderstorms and fog=不规则云层带有可能的雷暴和雾
irregular clouds with rain showers=不规则云层带有阵雨
irregular clouds with snow showers=不规则云层带有雪阵
irregular clouds with snow=不规则云层带雪
irregular clouds with strong thunderstorm=不规则云层带有强雷暴
irregular clouds with thunderstorms=不规则云层带雷暴
irregular clouds with very heavy rain=不规则云层带有非常大的雨
irregular=不规则的
light=轻的
local=局部的
low clouds with some clearings=低云带有一些晴朗区域
low=低的
mostly clear=大部分清晰
mostly=大部分
no precipitation=没有降水
no=没有
openings=开阔区域
or=或
overcast with drizzle and fog=阴天带细雨和雾
overcast with drizzle=阴天带细雨
overcast with freezing rain=阴天带冻雨
overcast with heavy snow of a blizzard nature and fog=阴天带暴风雪和雾
overcast with heavy snow of a blizzard nature=阴天带暴风雪
overcast with heavy snow=阴天带大雪
overcast with light rain and fog=阴天带轻雨和雾
overcast with light rain=阴天带轻雨
overcast with light snow and fog=阴天带轻雪和雾
overcast with light snow=阴天带轻雪
overcast with possible rain and fog=阴天带有可能的雨和雾
overcast with possible rain=阴天带有可能的雨
overcast with rain and fog=阴天带雨和雾
overcast with rain mixed with snow=阴天带雨混合雪
overcast with rain showers and fog=阴天带阵雨和雾
overcast with rain showers=阴天带阵雨
overcast with rain=阴天带雨
overcast with round snow showers=阴天带圆形雪阵
overcast with sleet and fog=阴天带冰雹和雾
overcast with sleet=阴天带冰雹
overcast with snow and fog=阴天带雪和雾
overcast with snow showers and fog=阴天带雪阵和雾
overcast with snow showers=阴天带雪阵
overcast with snow storms=阴天带雪暴
overcast with snow=阴天带雪
overcast=阴天
partly cloudy=部分多云
partly or partly cloudy with scattered haze=部分或部分多云带零星雾霾
partly=部分
possible=可能的
precipitation=降水
rain=雨
reduced visibility due to fog banks=由于雾霾带而能见度下降
round=圆形的
scattered clouds and clearings=分散云层和开阔区域
scattered clouds with drizzle=分散云层带细雨
scattered clouds with large clearings=分散云层带大开阔区域
scattered clouds with light rain=分散云层带轻雨
scattered clouds with light snow=分散云层带轻雪
scattered clouds with possible rain=分散云层带有可能的雨
scattered clouds with possible thunderstorms=分散云层带有可能的雷暴
scattered clouds with rain=分散云层带雨
scattered clouds with sleet=分散云层带冰雹
severe thunderstorms and fog=严重雷暴和雾
severe thunderstorms with hail=严重雷暴和冰雹
severe thunderstorms=严重雷暴
showers=阵雨
sky=天空
sleet=冰雹
sleets=冰雹
slight precipitation=轻微降水
slight=轻微的
snow=雪
some=一些
storms=暴风
strong=强的
thin high clouds=薄高云
thin=薄的
thunder=雷声
thunderstorm=雷暴
to=到
very cloudy or overcast with high clouds=非常多云或阴天带高云
very cloudy or overcast=非常多云或阴天
very cloudy with rain and thunderstorms and fog=非常多云带有雨、雷暴和雾
very cloudy with rain and thunderstorms=非常多云带有雨和雷暴
very heavy rain, locally flooding=非常大的雨，局部洪水
very=非常
visibility=能见度
weather=天气
with=与